WE ./assets/backroom.png
NO ./assets/backroom2.png
SO ./assets/backroom2.png       
EA ./assets/backroom.png

C 191,187,120
F 115,95,36

        1111111111111111111111111
        100P000000110000000000001
        1011000001110000001000001
        10010000000P000N001000001
111111111011000001110000000000001
10000000001100000111011111P111111
11110111111111P11100000010001
1111P111111111P11101010010001
110000001101010111000000P0001
10000000000000001100000010001
10000000000000001101010010001
11000001110101011111011110001
11110111 1110101 101111010001
11111111 1111111 111111111111
